1111111111111111111111111111111111
1E000C00000000C00000C0000000C00001
1C00000C000C0000000000000000C00001
111101010010000010100100C000010101
1000CCCCCCCCCCC0000000000000010101
100C00000000C0000000000000C00001C1
100C00000000C0000000000000C00001C1
100C00000000C0000000000000C00001C1
100C000CCC00C000CCCCCCCCC0C00001C1
100C00000000C0000000000000C00001C1
100C00CCCCCCCCCCCCCCCCCCCCCN0001C1
100C00000000C0000000000000C00001C1
100C00000000C0000000000000C00001C1
100C00CCCC00C000CCCCCCCC00C00001C1
100C0000P000C0000000000000C00001C1
100C00000000C0000000000000C00001C1
1111111111111111111111111111111111