1111111111111111111111111111111
1CCCCCCCCCCCCC111CCCCCCCCCCCCC1
1CC0000000000011100000000000CC1
1CC1100011110011100111100011CC1
1CC1100011110011100111100011CC1
1CCCCCCCCCCCCCCCCCCCCCCCCCCCCC1
1CCCCCCCCCCCCCCCCCCCCCCCCCCCCC1
1CC11CCC100111111111001CCC11CC1
1CC11CCC1CCCCCC1CCCCCC1CCC11CC1
1CC11CCC1CCCCCC1CCCCCC1CCC11CC1
1CC11CCC1CCCCCC1CCCCCC1CCC11CC1
1CC11CCC111110010011111CCC11CC1
1CC11CCC100000010000001CCC11CC1
1CC11CCC100000010000001CCC11CC1
10000CCC0000000P000000000000001
1CC00CCCCCC0000N000CCCCCC000CC1
1CC11CCC10011111111100100011CC1
1CC11CCC10000001000000100011CC1
1CC11CCC10000001000000100011CC1
1CCCCCCCCCCCCCC1CCCCCCCCCCCCCC1
1CCCCCCCCCCCCCC1CCCCCCCCCCCCCC1
1CC1110011110001000111100111CC1
1CC0010000000000000000000100CC1
1CCCC1000000000E0000000001CCCC1
1CCCCCCCCCCCCCCCCCCCCCCCCCCCCC1
1111111111111111111111111111111