1111111111111
10111110101011111
100000P11110111
1CCE10000000111
1000000000001
1000CCC001001
1111111111111