111111
111111
1CEP11
111111
111111