111111111111111
101111101010111
100000P11110111
1CCE10000000111
100000000000101
1000CCCC0100101
100000001110001
100000000010001
100000000000001
111111111111111