1111111111111111
1P0000000C000001
1EC0000CCCC00001
1111111111111111